111111111111111111111111
1010C00C0001000000C00011
10C10001000000C0C0000C01
1C01C0C10100011000000011
1CC1000C001000C0C0000C11
100000CCC0000C0P0000C001
10101000000C0010000CCC01
10C000000C0C1110C010C001
1C000C1C0000100CC1001CE1
10C00010CC01C00C00C1C001
1C0100111C0CC01000000001
111111111111111111111111
